############
#          #
#  ######  #
#  #    #  #
#  # $$ #  #
#  # .. #  #
#  #  @ #  #
#  ######  #
#          #
############
