################
#              #
#  ####  ####  #
#  #  ####  #  #
#  # $    $ #  #
#  # .    . #  #
#  ##  ##  ##  #
#     #  #     #
#     #@ #     #
#     ####     #
#              #
################
