##########
#        #
#  $ .   #
#  @ .   #
#  $ .   #
#        #
##########
