##############
#            #
#  .  .  .   #
#            #
#  $  $  $   #
#            #
#     @      #
#            #
##############
