########
#      #
# $@$  #
# . .  #
#      #
########
